10 10
1 1 1 1 1 1 1 1 1 1
1 2 2 2 X 3 3 2 2 1
1 1 1 2 2 2 2 1 1 1
1 3 1 X 1 1 2 1 3 1
1 1 1 1 2 1 1 1 1 1
1 2 3 1 1 1 2 2 1 1
1 1 1 1 1 X 1 1 1 1
1 2 2 3 1 1 1 2 2 1
1 1 1 1 1 1 1 1 1 1
1 1 3 2 2 2 2 3 1 1
